TTTTTTTTTTTTTTTTTTTTTTTTT
T       R     T         T
T   T T       T T   R   T
T   K     R T       T   T
T     T T   T   T   T   T
T         R     T K     T
T T T   T T           T T
T     T       T     T   T
T    R    T K   T T     T
T T     T       R       T
T     T   T T T   K   T T
T R           T         T
T T T T T T T T T T T T T
TTTTTT  TTTTTTTTTTTTTTTTT
T       R     T         T
T   T T       T T   R   T
T   K     R T       T   T
T     T T   T   T   T   T
T         R     T K     T
T T T   T T           T T
T     T       T     T   T
T    R    T K   T T     T
T T     T       R       T
T     T   T T T   K   T T
T R           T         T
T T T T T T T T T T T T T
